		Вид русской повествовательной литературы			1
		Совокупность записей, снимков и т.п., отражающих моменты развития чего-л.			2
		Другое			3
		Не могу определить			0
восточнославянские племена назывались по-разному, что известно нам из древнейшей русской	 летописи	: вятичи, кривичи, древляне, поляне, радимичи и другие.	1		
походов Игоря на греков, как мы об этом писали выше, имеются и в “Новгородской первой	 летописи	”. Договор 944 г., не вызвав в историографии столь бурных и бескомпромиссных споров	1		
с известием о начале монастырей уже во времена крестителя Руси кн. Владимира. Но	 летопись	, возможно, свидетельствует о том, что при кн. Ярославе Мудром начиналось существование	1		
газеты'. Кемерово.	 летописи	 кузбасса и россии - исполнилось десять лет со дня выхода в свет первого номера	2		
старейшими и основными списками являются Лаврентьевская и Ипатьевская летописи. В своей	 летописи	 Нестор первым из русских историков связал историю Руси с историей восточноевропейских	1		
многотиражная газета, буклет 'Профиль фирмы', Годовой отчет, Письмо к акционерам, история (	летопись	) фирмы, биография высшего руководства, слайдовый видеофильм или компьютерная презентация	2		
Токарева А. Отчего молодежь покидает библиотеки	 летописях	 Россия называлась Гардарики страна городов. Однако в силу нашей обширности и исторического	1		
протограф Симеоновской летописи или, быть может, точнее первых двух частей этой	 летописи	; 2) Тверская летопись, доведенная до 1374 г. и начинающаяся, как кажется, с 1285	1		
летописи гораздо больше по размеру, и еще раз подчеркнем, что с Радзивилловской	 летописью	 он одинаков лишь точным совпадением своего окончания. В Троицкой же пергаменной	1		
в загадочном деле внезапной смерти 15.05.1501 г. царевича Димитрия. Официальная	 летопись	 гласит, что царевича убили агенты Годунова, а все следствие о деле было годуновской	1		
закончено еще до этого. О строительстве Успенского собора Киево-Печерского монастыря в	 летописи	 сказано, что оно было завершершено 'на третее лето', не считая года закладки, т.е.	1		
геологии являются горные породы, в которых запечатлена и прослеживается геологическая	 летопись	 Земли. Также геология изучает современные физические процессы и механизмы, действующие	2		
 наконец, – новая страница – современная	 летопись	 жизни монастыря. Обитель вновь восстанавливается и продолжает существование, окормляемая	2		
заставляет казнить Щавеля, Иена и Трикса – Маркель не будет колебаться. Когда-то, читая	 летописи	 о деяниях великих королей (в первую очередь, конечно, Маркеля Разумного), Трикс	1		
развития характеризует эти две основные линии сибирского летописания. Тексты сибирских	 летописей	 XVII—XVIII вв. будут включены в два тома ПСРЛ. Том завершает Синодик Ермаковым	1		
месте Киева нескольких поселений, слившихся затем в одно большое.	 летописях	 город Киев впервые упоминается в 860 году. Возвышение Киева произошло из-за его	1		
искусстве 1950-60-х годов В художественной	 летописи	 Вологды ХХ века интересна каждая деталь. Сохранение прошлого и активное строительство	1		
личность [Текст] / Ю.Н.Караулов. – М.: Наука, 1987. – 264с. 4.Полное собрание русских	 летописей	. Т.1. Вып.2. Суздальская летопись по Лаврентьевскому списку. Изд-е 2-ое. – Ленинград	1		
Московский великокняжеский свод 1479 г., Ростовский свод 80-х годов XV в. и Ермолинская	 летопись	. Софийская вторая летопись сохранила первоначальные тексты 'Повести о Темир-Аксаке	1		
котором интересующее нас событие описывается формулой, принятой для Псковской 3-й	 летописи	, переписчик XVII в., думается, по собственному разумению, внес топографическую	1		
разбиваются по образцу китайских садов, которые существовали в этой стране, судя по	 летописям	, еще в VI в. До нашей эры...	1		
как мехового товара («соболи, куницы, белки») содержит не Лаврентьевская, а другие	 летописи	. Кроме того, процедура «немого торга» описана еще в арабо-персидских географических	1		
говорить о правдивости и точности изложенных в летописи материалах.	 летопись	 «Повесть временных лет» переписывалась несколько раз, вовсе не удивляет. Каждый	1		
Произведения его - это живительная кладезь мыслей, знаний, чувств, красок, это своеобразная	 летопись	 истории своего народа. Во всех довженковских произведениях постоянным аккордом	2		
мнение. И обвинители на Нюрнбергском процессе подчеркивали, что этот процесс явится	 летописью	, к которой историки смогут обращаться в поисках правды, а политики — в поисках	2		
на первомайском параде над Красной площадью.	 ЛЕТОПИСЬ	 оглавлением, на втором листе которого читаем: '!ПАНТОМИМА - АПОФЕОЗ!'- вот так	1		
Волховца – Жилотуг (маленьким утоп); жена Руса – Порусия; дочь Руса – Полиста [	 Летописи	, 1977 ]. Как мы уже указывали, на стоянке Сахтыш VIII в волосовском слое, в центре	1		
создана позиционная теория, рассказывает эта книга. Не даты, не имена, не факты	 летописи	 спортивных битв стоят в центре внимания автора. В первую очередь его интересует	1		
известие, скорее всего, новгородского происхождения, т. к. именно в новгородской группе	 летописей	 известие отнесено к 6645 мартовскому году, второе — взято из источника, сходного	1		
о рубинах датируются IV веком до н. э., встречаются они в индийских и бирманских	 летописях	. В Римской империи рубин чрезвычайно почитали, его ценили гораздо выше алмаза.	1		
Луи-Филиппа Первого. Что касается времен исторических, то здесь мне оказала большую помощь	 летопись	 Иоанна Тальпы, монаха Бергардинского монастыря. Я черпал из нее обильные сведения	1		
разрозненность листов и пропуски в нумерации. Но его утверждение, о том, что вводный раздел	 летописи	 набран из отдельных, плохо связанных между собой отрывков, имеет логические разрывы	1		
две трети затопленным Волго-Балтийской водной системой.	 летописи	 о Белоозере высвечивают лишь отдельные вехи его истории. Первыми его насельниками	1		
достаточно далеко на севере, в глубине лесной зоны (см. комментарий [21] ).	 летописях	 русь двулика. С одной стороны — это варяги, скитальцы и пираты, «находники» по	1		
двух экспозиционных залов: в первом отражена история Великой Отечественной войны в	 летописи	 нашего города, во втором представлены материалы, рассказывающие о военных событиях	2		
конце концов, когда внутренние противоречия достигли большого накала, как говорит	 летопись	, 'встал род на род' и началась большая усобица - новгородцы совершили тот политический	1		
Свода 1305 г.». 60) Если наличие двух протографов у Софийской I и Новгородской IV	 летописей	 не представляется необходимым, то существование «основного свода», к которому восходят	1		
заключается еще и в том, что первые рассказы о битве в Рогожском летописце, Симеоновской	 летописи	, новгородском летописании очень кратки. Новгородский список к тому же тенденциозен	1		
город на реке Гнезна, в 23 км к северо-востоку от Тернополя. Впервые упомянут в	 летописи	 под 1221 как центр удельного княжества в составе Галицко-Волынского княжества.	1		
производстве строительных работ или специальных раскопок.	 летописях	 и старинных преданиях (какой древний город русский не имеет своих легенд! ) лишь	1		
исследователя еврейской истории города, в	 летописи	 под названием «Евреи Рима» появится еще много новых глав.	1		
разобрались в ситуации и сочли каждое из имен именем отдельного человека.	Летописи	, написанные на Западе, именовали Империю 'Великой', то есть, в несколько искаженном	1		
обозначения в самых старших текстах русской	 летописи	 Simargla или S mar gla, Semar gla могло возникнуть, уже как обычное, Sima Rgla,	1		
Здравствуйте,о.Аркадий! Подскажите, пожалуйста, где можно приобрести книгу 'Духовная	 летопись	 Забайкалья'.	1		
по-человечески? И на этот вопрос ведь имеется столь же однозначный ответ во всех	 летописях	. Но это люди в целом некультурные, летописи не читают, а к истории относятся пренебрежительно	1		
которого я создан. Мне стало наплевать на все, и я сделался художником группы '	летопись	'. По вторникам мы собирались у нелли полетаевой, где пили чай и обсуждали новые	2		
княжил Вит (Вид), по прозванию Волк - неизвестный польским и литовским хроникам. По	 летописям	 Вит был сыном Давыда Ростиславича, внуком Ростислава Полоцкого , сосланного в Грецию	1		
«героический реализм», рассматривая живопись как историческое свидетельство, как	 летопись	 эпохи.	2		
овдовевшей, разочаровавшейся в брате, но все еще не павшей духом, - слишком личная	 летопись	. И сейчас устремляется. Тиффани завопила и вскочила на ноги.	2		
в России стала пожарная команда города Осташков. Еще в 1809 году, как повествует	 летопись	, был составлен приговор 'О сборе с купцов и мещан по 25 копеек с каждого окладного	1		
утверждалась в полемике с А.Г.Кузьминым, полагавшим, что всякое предварительное изучение	 летописи	 – задача филологов, а не историков. В центре споров – понимание «духа времени».	1		
VII-VIII веков. н.э. происходит поступательное развитие поселения, названного в	 летописях	 под 903 г. Псковом.	1		
только обуви и что они могут поиметь (кроме как закрыть) с частника на базаре? �	Летопись	</p><p>	0		
княжение Ярослава в Киеве с началом закладки Св. Софии - речь идёт в Новгородской	 летописи	 (и действительно он впервые появился в Киеве в конце 1016 г, как новгородский князь	1		
виды наказаний: 1. Смертная казнь . Русская Правда не говорит о смертной казни, но	 летописи	 сообщают о её применении. Смертная казнь применялась к восставшим против княжеской	1		
делись? Естественно предположить, что их впоследствие сожгли.	 летописи	, крещение киевлян в 988 году прошло достаточно спокойно. А вот свободолюбивый Новгород	1		
страницу в Летописи.ру	 Летописи	.ру начали пополняться видеороликами. Видео выставляются в формате *.swf, т.е. в	3		
его недалекости. Ну как, соглашались? Все больше эта смута подсказывала кровавую	 летопись	 реала, когда воля воспринималась всяким, как личная неограниченная власть и право	1		
страны, наши предки связывали с именем именно этого апостола.	 летописи	 “Повесть временных лет”, почти две тысячи лет назад апостол Андрей во время своего	1		
помещает событие под 920 годом, но это уже сдвиг в хронологии, столь обычный для	 летописей	.)	1		
хранения анонимности. На компе никак не сохранится практически никаких отпечатков в	 летописи	, cookies и иных атрибутов передовых ресурсов. Но данный режим никак не оберегает	2		
ОБА-Нанас	Летопись	 - ОБА-Напись	0		
познакомились с книжными выставками — « Героическая	 летопись	 военных лет » и « России славные сыны », где были представлены книги по истории	2		
сношений меду разными племенами государства; мудрым правлением она снискала в русских	 летописях	 бессмертное имя. Владимир Великий, сын деятельного воин и завоевателя, Святослава	1		
года истории Советского режима — сплошная	 летопись	 кровавой и жестокой борьбы русского народа с захватчиками, представителями и ставленниками	2		
увеличение простаты, нарушения печени.	 летопись	 борьбы за Советскую власть на Дону навечно вписано имя бесстрашного казака Ф. Г.	2		
Пусть уйдут из его памяти все перипетии и происшествия! Пусть будут вычеркнуты из	 летописи	 его зрелого возраста мечты и ночные кошмары, обретения ума и глупости!	2		
город Приднестровья Бендеры отмечает в среду 600-летие со дня первого упоминания в	 летописи	.	1		
литературно-художественные тексты, включенные в свод.	 летопись	</p><p>	1		
Можно и не быть особым знатоком сталинской	 летописи	 страны, чтобы признать случившееся с Башиловым по-своему уникальным фактом, когда	2		
династия Аспургов на Боспорском престоле. Битвы с херсонесцами по описанию языческой	 летописи	.	1		
как каменные или обнаружены археологическими исследованиями [4] . Но указания в	 летописях	 на пожары упоминают очень значительное число деревянных церквей на улицах средневековых	1		
возникнуть в 60-х годах XII в. при Андрее или в 70-80-х годах при Всеволоде. Но из	 летописей	 точно известно, что в 1216 г. она была сожжена. Городок-крепость на Дубенском устье	1		
севера Руси; 3) лет 100 спустя Нестор создал Повесть временных лет, взяв в основу	 летопись	 Иоакима, но приспособив ее к югу Руси, ибо Новгород в XI веке явно второстепенным	1		
туристско-краеведческой экспедиции пионеров и школьников «Моя Родина — СССР», экспедиции «	Летопись	 Великой Отечественной», операции «Пионерская слава». Тематика бесед, утренников	2		
Котёл обязательно разорвёт. Остальное не ко мне.	Летопись	 снов	2		
советский очерк (1917-1941) (М., 1967), «Чтобы шагнуть в завтра» (Уфа, 1982), «	Летопись	 современности» (Уфа, 1985), «На стремнине» (Уфа, 1988), «Человек во времени» (М.	2		
областной ХII краеведческой конференции '	Летопись	 сибирских деревень' стала Ли Ю., 11-1 класс, с работой 'Сравнительный анализ представлений	2		
летописцу' в Великий Устюг она прибыла 7 октября 1556 года. Вот как об этом говорится в	 летописи	: 'В лето 7065. С Покрова учали судити по городам и по станом земские судьи. Того	1		
специально построенную исследовательскую среду. Мы можем использовать сеть и материалы	 Летописи	, для того чтобы организовывать изучение нового материалы, которого вне сети просто	0		
история русско-половецкого противоборства.	 летописи	</p><p>	0		
искусства. Среди авторов сборника К.Симонов, И.Эренбург, Н.Т.Федоренко, Б....	Летопись	 мужества (Илья Эренбург)	2		
разведчики из Руси, сообщая о делах в Чернигове в Стародубе. Область вятичей по контексту	 летописи	 не включенная в Русь, а противопоставлена эгей 29 .	1		
стрелки. Здесь же говорится, что мордва имела небольшие укрепления, называемые в	 летописях	 «мордовскими твердями». Была ли такая «твердь» на месте Мокшана? Доказать подобное	1		
черниговско-северским князем Святославом Ольговичем. Через девять лет, в 1156 г., запись в Тверской	 летописи	 гласит о том, что тот же князь Юрий заложил крепость Москву в устье реки Неглинной	1		
растений. Их споры, так называемые трилетные споры, появляются в палеонтологической	 летописи	 уже в конце ордовика, как теперь выяснили палеонтологи. Трилетные споры отличаются	2		
немногочисленных и малословных источников, какими здесь предстают сообщения русских	 летописей	, на сохранившиеся документы Царского архива, как, например, роспись свадебного	1		
окружен пригородными слободами с крестьянским населением. Имя реки Оскол встречается в	 летописях	 еще в XII в … Энциклопедический словарь Ф.А. Брокгауза и И.А. Ефрона	1		
два часа, пока толпа находилась во дворце, страдал ни в чем не повинный человек.	 Летопись	 одной из церквей в Меце (Лотарингия) рассказывает, что кардиналы, до того как выбрать	1		
говорили 'посвященные' барды (между ними есть и такие), что огромная коллекция их	 летописей	, начальные свитки коих написаны с устных преданий, пополняет все пробелы и даже	1		
От старшекурсников воспринимались неписанные традиции училища и познавалась его	 летопись	. Новички должны были запомнить знаменитых 'предков', когда-то учившихся в стенах	2		
Якуна. Для уточнения вопроса о причине гнева Всеволода надо обратиться к другим	 летописям	. Дело в том, что перед тем как разгневаться, киевский князь послал в Новгород своего	1		
исторического исследования, которое позволяет читать «нечитаемые» фразы и слова	 летописей	 и хроник. Термины манчжурских языков применимы и для названий многих древних городов	1		
проживала отдельно, потому, что вышла замуж. Мне хотелось бы узнать - отражены ли в	 летописи	 истории Забайкалья события тех дней с цифрами, фактами, именами и фамилиями. Также	1		
Позднее Воронож неоднократно упоминается в	 летописях	 в связи с трагическими для Руси событиями 1237 года, когда началось татаро-монгольское	1		
имел отношение Игумен к белому духовенству Пскова и его соборам — не известно. Из	 летописей	 видно, что игумены вместе со старшими священниками стояли во главе народа и во	1		
Российской армии, в процессе создания армии XXI века.	 летопись	 героизма, проявленного советскими воинами в годы Великой Отечественной войны. Масштабы	2		
археологическими работами. Характерный пример. В 1016 г., как сообщает Новгородская первая	 летопись	, во время конфликта новгородцев с варягами горожане, «собращася в нощь, исекоша	1		
и мировой договор» – у Папиния; «обыкновение человеческой участи» – у Тацита («	Летопись	», VI); «общая надежда» – у оратора Лисия. Кто, по славам Клавдиана («Война с Гильдом	1		
наших дней» - огромный труд, не возвышающийся, однако, над уровнем прагматической	 летописи	. Иост писал всеобщую историю евреев на основании старых источников, неполных и	2		
